4 4 4 4 4 4 4 4 4 4 4 4 4 4 4 4 4 4 4 4 4 4 4 4 4 4 4 4 4 4 4 4 4 4 4 4 4 4 4 4 4 4 4 4 4 4 4 4 4 4
4 4 4 4 4 0 0 5 5 5 5 5 5 5 5 5 5 5 5 5 5 5 5 5 5 5 5 5 5 5 5 5 5 5 5 5 5 5 5 5 5 5 5 0 0 4 4 4 4 4
4 4 4 4 0 0 5 5 3 3 3 3 5 0 0 0 0 0 0 0 0 0 0 0 5 0 0 0 0 0 0 0 0 0 0 0 0 0 0 0 0 0 5 5 0 0 4 4 4 4
4 4 4 0 0 5 5 3 3 4 4 3 5 0 0 0 0 0 0 0 0 0 0 5 5 5 0 0 0 0 0 0 0 0 0 0 0 0 0 0 0 0 0 5 5 0 0 4 4 4
4 4 0 0 5 5 3 3 4 4 4 3 5 0 0 0 0 0 0 0 0 0 5 5 2 5 5 0 0 0 0 0 0 0 0 0 0 0 0 0 0 0 0 0 5 5 0 0 4 4
4 0 0 5 5 3 3 4 4 4 4 3 5 0 0 0 0 0 0 0 0 5 5 2 2 2 5 5 0 0 0 0 0 0 0 0 0 0 0 0 0 0 0 0 0 5 5 0 0 4
4 0 5 5 3 3 4 4 4 4 4 3 5 0 0 0 0 0 0 0 0 5 2 2 2 2 2 5 0 0 0 0 0 0 0 0 0 0 0 0 0 0 0 0 0 0 5 5 0 4
4 5 5 3 3 4 4 4 4 4 4 3 5 0 0 0 0 0 0 0 0 5 2 2 2 2 2 5 0 0 0 0 0 0 4 4 3 4 4 0 0 0 0 0 0 0 0 5 5 4
4 5 3 3 4 4 4 4 4 4 4 3 5 0 0 0 0 0 0 0 0 5 5 2 2 2 5 5 0 0 0 0 0 0 4 3 3 3 4 4 4 4 0 0 0 0 0 0 5 4
4 5 3 4 4 4 4 4 4 4 4 3 5 0 0 0 0 0 0 0 0 0 5 5 0 5 5 0 0 0 0 0 0 0 4 3 3 3 4 3 3 4 0 0 0 0 0 0 5 4
4 5 3 4 4 4 4 4 4 4 4 3 5 0 0 0 0 0 0 0 0 0 0 5 5 5 0 0 0 0 0 0 0 0 4 3 3 3 3 3 3 4 0 0 0 0 0 0 5 4
4 5 3 3 3 3 3 3 3 3 3 3 5 0 0 0 0 0 0 0 0 0 0 0 5 0 0 0 0 0 0 0 0 0 4 4 4 4 4 4 4 4 0 0 0 0 0 0 5 4
4 5 5 5 5 5 5 5 5 5 5 5 5 0 0 0 0 0 0 0 0 0 0 0 5 0 0 0 0 0 0 0 0 0 0 0 0 0 0 0 0 0 0 0 0 0 0 0 5 4
4 5 3 3 3 3 3 3 3 3 3 3 5 0 0 0 0 0 0 0 0 0 0 0 5 0 0 0 0 0 0 0 0 0 0 0 0 0 0 0 0 0 0 0 0 0 0 0 5 4
4 5 3 4 4 4 4 4 4 4 4 3 5 0 0 0 0 0 0 0 0 0 0 0 5 0 0 0 0 0 0 0 0 0 0 0 0 0 0 0 0 0 0 0 0 0 0 0 5 4
4 5 3 4 2 2 2 2 2 2 4 3 5 0 0 0 0 0 0 0 0 0 0 0 5 0 0 0 0 0 0 0 0 0 0 0 0 0 0 0 0 0 0 0 0 0 0 0 5 4
4 5 3 4 2 2 2 2 2 2 4 3 5 0 0 0 0 0 0 0 0 0 0 0 5 0 0 0 0 0 0 0 0 0 0 0 0 0 0 0 0 0 0 0 0 0 0 0 5 4
4 5 3 4 2 2 2 2 2 2 4 3 5 0 0 0 0 0 0 0 0 0 0 0 5 0 0 0 0 0 0 0 0 0 0 0 0 0 0 0 0 0 0 0 0 0 0 0 5 4
4 5 3 4 2 2 3 3 3 3 3 3 5 0 0 0 0 0 0 0 0 0 0 0 5 0 0 0 0 0 0 0 0 0 0 0 0 0 0 0 0 0 0 0 0 0 0 0 5 4
4 5 3 4 2 2 2 2 2 2 4 3 5 0 0 0 0 0 0 0 0 0 0 1 5 1 0 0 0 0 0 0 0 0 0 0 0 0 0 0 0 0 0 0 0 0 0 0 5 4
4 5 3 4 2 2 2 2 2 2 4 3 5 0 0 0 0 0 0 0 0 0 1 1 5 1 1 0 0 0 0 0 0 0 0 0 0 0 0 0 0 0 0 0 0 0 0 0 5 4
4 5 3 4 2 2 2 2 2 2 4 3 5 0 0 0 0 0 0 0 0 1 1 5 5 5 1 1 0 0 0 0 0 0 0 0 0 0 0 0 0 0 0 0 0 0 0 0 5 4
4 5 3 4 4 4 4 4 4 4 4 3 5 0 0 0 0 0 0 0 1 1 5 5 5 5 5 1 1 0 0 0 0 0 0 0 0 0 0 0 0 0 0 0 0 0 0 0 5 4
4 5 3 3 3 3 3 3 3 3 3 3 5 0 0 0 0 0 0 1 1 5 5 5 5 5 5 5 1 1 0 0 0 0 0 0 0 0 0 0 0 0 0 0 0 0 0 0 5 4
4 5 5 5 5 5 5 5 5 5 5 5 5 5 5 5 5 5 5 5 5 5 5 5 5 5 5 5 5 5 5 5 5 5 5 5 5 5 5 5 5 5 5 5 5 5 5 5 5 4
4 5 0 0 0 0 0 0 0 0 0 0 5 0 0 0 0 0 0 1 1 5 5 5 5 5 5 5 1 1 0 0 0 0 0 0 0 0 4 0 4 0 0 0 0 0 0 0 5 4
4 5 0 0 0 0 0 0 0 0 0 0 5 0 0 0 0 0 0 0 1 1 5 5 5 5 5 1 1 0 0 0 0 0 0 0 0 0 4 0 4 0 0 0 0 0 0 0 5 4
4 5 0 0 0 0 0 0 0 0 0 0 5 0 0 0 0 0 0 0 0 1 1 5 5 5 1 1 0 0 0 0 0 0 0 0 0 0 4 0 4 0 0 0 0 0 0 0 5 4
4 5 0 0 4 4 4 4 4 0 0 0 5 0 0 0 0 0 0 0 0 0 1 1 5 1 1 0 0 0 0 0 0 0 0 0 0 0 4 0 4 0 0 0 0 0 0 0 5 4
4 5 0 0 4 0 0 0 4 4 4 4 5 0 0 0 0 0 0 0 0 0 0 1 5 1 0 0 0 0 0 0 0 0 0 0 0 0 4 4 4 0 0 0 0 0 0 0 5 4
4 5 0 0 4 0 0 0 0 0 0 0 5 0 0 0 0 0 0 0 0 0 0 0 5 0 0 0 0 0 0 0 0 0 0 0 0 0 0 0 0 0 0 0 0 0 0 0 5 4
4 5 0 0 4 0 0 0 4 4 4 4 5 0 0 0 0 0 0 0 0 0 0 0 5 0 0 0 0 0 0 0 0 0 0 0 0 0 0 0 0 0 0 0 0 0 0 0 5 4
4 5 0 0 4 4 4 4 4 0 0 0 5 0 0 0 0 0 0 0 0 0 0 0 5 0 0 0 0 0 0 0 0 0 0 0 0 0 0 0 0 0 0 0 0 0 0 0 5 4
4 5 0 0 0 0 0 0 0 0 0 0 5 0 0 0 0 0 0 0 0 0 0 0 5 0 0 0 0 0 0 0 0 0 0 0 0 0 0 0 0 0 0 0 0 0 0 0 5 4
4 5 0 0 0 0 0 0 0 0 0 0 5 0 0 0 0 0 0 0 0 0 0 0 5 0 0 0 0 0 0 0 0 0 0 0 0 0 0 0 0 0 0 0 0 0 0 0 5 4
4 5 0 0 0 0 0 0 0 0 0 0 5 0 0 0 0 0 0 0 0 0 0 0 5 0 0 0 0 0 0 0 0 0 0 0 0 0 0 0 0 0 0 0 0 0 0 0 5 4
4 5 0 0 0 0 0 0 0 0 0 0 5 0 0 0 0 0 0 0 0 0 0 0 5 0 0 0 0 0 0 0 0 0 0 0 0 0 0 0 0 0 0 0 0 0 0 0 5 4
4 5 0 0 0 0 0 0 0 0 0 0 5 0 0 0 0 0 0 0 0 0 0 0 5 0 0 0 0 0 0 0 0 0 4 4 4 4 4 4 0 0 0 0 0 0 0 0 5 4
4 5 0 0 0 0 0 0 0 0 0 0 5 0 0 0 0 0 0 0 0 0 0 0 5 0 0 0 0 0 0 0 0 0 4 3 3 3 3 4 0 0 0 0 0 0 0 0 5 4
4 5 0 0 0 0 0 0 0 0 0 0 5 5 5 5 5 5 5 5 5 5 5 5 5 0 0 0 0 0 0 0 0 0 4 3 3 3 3 0 0 0 0 0 0 0 0 0 5 4
4 5 0 0 0 0 0 0 0 0 0 0 5 4 4 4 4 4 3 4 4 4 4 4 5 0 0 0 0 0 0 0 0 0 4 3 3 3 3 4 0 0 0 0 0 0 0 0 5 4
4 5 0 0 0 0 0 0 0 0 0 0 5 4 2 2 2 4 3 4 2 2 2 4 5 0 0 0 0 0 0 0 0 0 4 4 4 4 4 4 0 0 0 0 0 0 0 0 5 4
4 5 5 0 0 0 0 0 0 0 0 0 5 4 2 2 2 4 3 4 2 2 2 4 5 0 0 0 0 0 0 0 0 0 0 0 0 0 0 0 0 0 0 0 0 0 0 5 5 4
4 0 5 5 0 0 0 0 0 0 0 0 5 4 2 2 2 4 3 4 2 2 2 4 5 0 0 0 0 0 0 0 0 0 0 0 0 0 0 0 0 0 0 0 0 0 5 5 0 4
4 0 0 5 5 0 0 0 0 0 0 0 5 4 2 2 2 4 4 4 2 2 2 4 5 0 0 0 0 0 0 0 0 0 0 0 0 0 0 0 0 0 0 0 0 5 5 0 0 4
4 4 0 0 5 5 0 0 0 0 0 0 5 4 2 2 2 2 2 2 2 2 2 4 5 0 0 0 0 0 0 0 0 0 0 0 0 0 0 0 0 0 0 0 5 5 0 0 4 4
4 4 4 0 0 5 5 0 0 0 0 0 5 4 2 2 2 2 2 2 2 2 2 4 5 0 0 0 0 0 0 0 0 0 0 0 0 0 0 0 0 0 0 5 5 0 0 4 4 4
4 4 4 4 0 0 5 5 0 0 0 0 5 4 4 4 4 4 4 4 4 4 4 4 5 0 0 0 0 0 0 0 0 0 0 0 0 0 0 0 0 0 5 5 0 0 4 4 4 4
4 4 4 4 4 0 0 5 5 5 5 5 5 5 5 5 5 5 5 5 5 5 5 5 5 5 5 5 5 5 5 5 5 5 5 5 5 5 5 5 5 5 5 0 0 4 4 4 4 4
4 4 4 4 4 4 4 4 4 4 4 4 4 4 4 4 4 4 4 4 4 4 4 4 4 4 4 4 4 4 4 4 4 4 4 4 4 4 4 4 4 4 4 4 4 4 4 4 4 4